***************
*.............*
*.*.*.*.*.*.*.*
*......E......*
*.***********.*
*.............*
*.*.*.*.*.*.*.*
*.............*
*.*.*.*.*.*.*.*
*.............*
*.*.*.*.*.*.*.*
*..S..........*
*.*.*.*.*.*.*.*
*.............*
***************
